2
6 5
#####
#A#A##
# # A#
#S ##
#####
7 7
#####
#AAA###
# A#
# S ###
# #
#AAA###
#####